...###...##
.##.#.###.#
.#.#..##..#
##...#....#
#...@.#..#.
#.##.##...#
..#..###..#
##.##.#..##
.#.#..##.##
..#########